1111111....1
1.p....1....
1.....1...1.
111111....11
1.....1...11
1......1.111
1......11111
1111111.1.1.
